┌──────────────────────────────────────────────────────────────────────────────────────────────┐
│                                                                                              │
│                                                                                              │
│                                      코로나 환자 관리 프로그램                               │
│                                                                                              │
│                                                                                              │
│                                                                                              │
│                                                                                              │
│                                          병실 추가                                           │
│                                                                                              │
│                                                                                              │
│                                                                                              │
│        병실 호수 :                                                                           │
│                                                                                              │
│        병실 최대 인원 :                                                                      │
│                                                                                              │
│                                                                                              │
│                                                                                              │
│                                                                                              │
│                                                                                              │
│                                                                                              │
│                                                                                              │
│                                                                                              │
│                                                                                              │
│                                                                                              │
│                                                                                              │
└──────────────────────────────────────────────────────────────────────────────────────────────┘