┌──────────────────────────────────────────────────────────────────────────────────────────────┐
│                                                                                              │
│                                                                                              │
│                                  코로나 환자 관리 프로그램                                   │
│                                                                                              │
│                                                                                              │
│                                                                                              │
│                                                                                              │
│                                         메뉴 선택 :                                          │
│                                                                                              │
│                                                                                              │
│                        환자 관리                               병실 관리                     │
│                                                                                              │
│                                                                                              │
│                                                                1. 병실 추가                  │
│                                                                                              │
│                                                                2. 병실 조회                  │
│                                                                                              │
│                                                                3. 병실 정보 수정             │
│                                                                                              │
│                                                                4. 병실 삭제                  │
│                                                                                              │
│                                                                5. 뒤로 가기                  │
│                                                                                              │
│                                                                                              │
│                                                                                              │
└──────────────────────────────────────────────────────────────────────────────────────────────┘