┌──────────────────────────────────────────────────────────────────────────────────────────────┐
│                                                                                              │
│                                                                                              │
│                                      코로나 환자 관리 프로그램                               │
│                                                                                              │
│                                                                                              │
│                                                                                              │
│                                                                                              │
│                                          병실 조회                                           │
│                                                                                              │
│                                                                                              │
│                                          병실 호수 :                                         │
│                                                                                              │
│              ┌─────────────────────┬─────────────────────┬─────────────────────┐             │
│              │      병실 호수      │      최대 인원      │      현재 인원      │             │
│              ├─────────────────────┴─────────────────────┴─────────────────────┤             │
│              │                                                                 │             │
│              │                                                                 │             │
│              │                                                                 │             │
│              │                                                                 │             │
│              │                                                                 │             │
│              │                                                                 │             │
│              │                                                                 │             │
│              │                                                                 │             │
│              │                                                                 │             │
│              └─────────────────────────────────────────────────────────────────┘             │
│                                                                                              │
└──────────────────────────────────────────────────────────────────────────────────────────────┘